target_count_meta,ADC,VHH,bispecific_IgG_like,bispecific_scFv_like,fusion,monospecific_IgG_Fab,radiolabeled,Total
1,23,10,1,1,22,416,3,476
2,22,18,83,60,18,255,3,459
3,12,0,0,0,5,143,2,162
4,1,1,0,0,0,20,0,22
5,0,0,0,0,0,6,0,6
6,0,0,0,0,0,7,0,7
7,0,0,0,0,0,1,0,1
Total,58,29,84,61,45,848,8,1133
